11111111111111
10010000000001
10000111110001
100011E000P001
11111111111111
