1111111111111111111111111111111111
1E00000000X0000C00000C000000000001
1010010100100000101001000000010101
10100100101010100010010000X0010101
1P0000000C00C0000X00000000000000C1
1111111111111111111111111111111111
