1111111111111
100100C0CCC01
1000011111001
10X011E000P01
1111111111111
