1111111111111
100100C0CCC01
1000011111001
1CXC11E000P01
1111111111111
